+--+--+--+--+--+--+--+--+--+--+--+--+--+--+--+--+--+--+--+--+
S                 |     |                                |  |
+  +--+--+  +--+--+  +  +  +--+--+--+  +--+--+--+  +--+  +  +
|     |  |     |     |  |        |  |     |        |     |  |
+--+  +  +--+  +  +--+  +--+--+  +  +--+  +  +--+--+--+  +  +
|     |     |     |  |  |        |     |  |     |     |     |
+  +--+  +  +--+--+  +  +  +--+--+--+  +  +--+  +  +  +--+--+
|  |     |        |  |     |           |  |     |  |  |     |
+  +--+--+  +--+  +  +--+--+  +--+--+--+--+  +  +  +  +  +  +
|           |     |        |           |     |  |  |     |  |
+--+--+--+--+  +--+  +  +--+--+--+--+  +  +--+--+  +--+--+  +
|  |        |     |  |  |           |  |  |              |  |
+  +  +  +--+--+  +  +--+  +--+--+  +  +  +  +--+--+--+--+  +
|     |        |  |  |     |  |     |  |     |              |
+  +--+--+--+  +  +  +  +--+  +  +--+  +--+--+  +--+--+--+  +
|  |        |     |  |     |  |        |        |        |  |
+  +  +  +  +--+--+  +--+  +  +--+--+--+  +--+--+  +  +--+  +
|  |  |  |  |        |  |     |           |     |  |  |     |
+  +--+  +  +  +--+  +  +--+  +  +--+--+--+  +--+  +  +  +--+
|        |     |           |     |                 |        G
+--+--+--+--+--+--+--+--+--+--+--+--+--+--+--+--+--+--+--+--+
