+--+--+--+--+--+--+--+--+--+--+--+--+--+--+--+--+--+--+--+--+
|                    |        |                       |     |
+  +--+--+--+--+  +--+  +--+  +  +--+  +--+--+--+--+  +--+  +
|  |        |     |     |  |     |     |        |  |  |     |
+  +--+  +--+  +--+  +--+  +--+--+  +--+  +  +  +  +  +  +--+
|     |     |        |        |     |     |  |     |  |     |
+--+  +--+  +--+--+--+  +  +  +  +--+  +--+  +--+--+  +--+  +
|     |        |        |  |  |  |        |  |     |     |  |
+  +--+  +--+  +  +--+--+  +  +  +  +--+--+  +  +  +--+  +  +
|     |     |  |     |     |  |  |  |     |     |     |     G
+--+  +  +  +  +--+  +  +--+  +  +  +--+  +  +--+--+  +--+  +
S     |  |  |     |  |  |     |  |     |  |  |     |        |
+  +--+  +  +--+--+  +  +  +--+  +--+--+  +  +  +--+--+  +--+
|  |     |     |     |  |     |     |     |     |     |     |
+  +--+--+--+  +  +--+  +--+--+--+  +  +--+  +--+  +  +--+--+
|           |        |     |        |     |  |     |  |     |
+--+--+--+  +  +--+--+--+  +  +--+  +--+  +--+  +--+  +  +  +
|     |     |  |        |  |  |        |        |  |     |  |
+  +  +  +--+--+  +--+  +  +  +--+--+--+--+--+--+  +--+--+  +
|  |              |        |                                |
+--+--+--+--+--+--+--+--+--+--+--+--+--+--+--+--+--+--+--+--+
