+--+--+--+--+--+--+--+--+--+--+--+--+--+--+--+--+--+--+--+--+
|           |     |     |     |     |                    |  G
+--+  +--+  +--+  +  +  +  +  +  +  +--+--+  +--+--+--+  +  +
|     |     |     |  |     |     |        |  |           |  |
+  +--+--+  +  +  +  +--+--+--+--+--+--+--+  +  +--+--+--+  +
|  |     |     |  |     |  |           |     |     |        |
+  +  +  +--+--+  +--+  +  +  +  +--+  +  +--+--+  +  +--+  +
|     |  |        |  |  |     |  |  |     |     |     |  |  |
+--+--+  +--+--+  +  +  +--+--+  +  +--+--+  +  +--+--+  +  +
|     |        |     |        |  |  |        |              |
+  +  +--+--+  +--+  +--+--+  +  +  +  +--+--+--+--+--+--+--+
|  |           |           |     |  |  |                    |
+  +--+--+  +--+--+--+--+--+--+--+  +  +  +--+--+--+--+--+  +
|     |     |        |              |     |        |  |     |
+--+  +  +--+  +--+  +  +--+--+--+  +--+--+--+  +  +  +  +--+
|     |     |  |  |     |        |              |     |     |
+  +--+--+--+  +  +--+--+  +--+  +--+--+  +  +--+--+--+--+  +
|  |     |     |        |  |     |  |     |  |           |  |
+  +  +  +  +--+  +--+  +  +  +--+  +  +--+--+  +--+--+  +  +
S     |           |        |        |                 |     |
+--+--+--+--+--+--+--+--+--+--+--+--+--+--+--+--+--+--+--+--+
