+--+--+--+--+--+--+--+--+--+-S+--+--+--+--+--+--+--+--+--+--+
|        |                 |                 |  |     |     |
+  +--+  +  +--+--+--+--+  +--+  +--+--+--+  +  +  +  +  +  +
|  |  |     |     |     |     |  |     |        |  |     |  |
+  +  +--+--+  +--+  +  +--+  +  +  +  +  +--+--+  +--+--+  +
|  |        |        |     |  |  |  |     |        |        |
+  +--+  +  +  +--+--+  +--+  +  +--+--+  +  +--+--+  +--+--+
|     |  |           |           |     |  |  |        |     |
+--+  +--+--+--+--+--+--+  +--+--+  +  +--+  +--+--+  +  +  +
|     |        |        |     |     |     |        |     |  |
+  +--+  +--+  +  +--+  +  +--+  +--+--+  +--+--+  +--+--+  +
|  |     |  |        |  |  |     |     |  |        |     |  |
+  +  +--+  +--+--+--+  +  +  +--+  +  +  +  +--+--+  +--+  +
|     |           |     |  |     |  |  |  |     |     |     |
+  +--+--+  +--+  +  +--+  +--+  +  +  +  +--+  +  +--+  +--+
|  |        |  |  |     |     |  |  |  |     |     |     |  |
+  +  +  +--+  +  +--+  +--+--+  +  +  +--+  +--+--+  +--+  +
|  |  |  |     |     |        |  |  |     |        |  |     |
+  +--+  +  +  +--+  +--+--+  +  +  +--+  +--+--+  +  +--+  +
|        |  |              |        |           |           |
+--+--+--+G-+--+--+--+--+--+--+--+--+--+--+--+--+--+--+--+--+
