+--+--+--+--+--+--+--+--+--+--+--+--+--+--+--+--+--+--+--+--+
|        |     |     |                       |        |     |
+  +--+  +  +  +  +  +--+--+--+--+--+  +--+  +  +--+  +--+  +
G     |     |  |  |     |        |  |  |  |     |  |  |     |
+--+--+--+--+  +  +--+  +  +--+  +  +  +  +--+--+  +  +  +  +
|              |     |  |  |  |     |  |     |        |  |  |
+  +--+--+  +--+  +--+  +  +  +--+--+  +  +  +  +--+--+  +  +
|     |     |     |     |  |  |        |  |              |  |
+  +  +  +--+  +--+  +--+  +  +  +--+  +--+  +--+--+--+--+--+
|  |  |     |     |        |     |  |     |     |           S
+  +  +--+--+--+  +--+--+--+--+  +  +--+  +--+--+  +--+--+  +
|  |           |              |     |  |           |        |
+  +--+--+  +  +--+--+--+--+  +--+  +  +--+--+  +--+  +--+  +
|        |  |     |        |  |  |  |  |     |  |     |     |
+  +--+--+  +--+--+  +  +--+  +  +  +  +  +  +  +  +--+  +--+
|  |        |     |  |        |        |  |  |  |  |        |
+  +  +--+  +  +  +  +--+--+--+--+--+--+  +  +--+  +--+--+  +
|  |     |  |  |  |  |        |           |     |     |     |
+  +--+  +--+  +  +  +--+  +  +  +--+--+--+--+  +--+  +  +--+
|     |        |           |     |                    |     |
+--+--+--+--+--+--+--+--+--+--+--+--+--+--+--+--+--+--+--+--+
