+--+--+--+--+--+--+--+--+--+--+--+--+--+--+--+--+--+--+--+--+
|              |     |                    |                 |
+  +--+  +--+  +--+  +  +--+--+  +--+--+--+  +--+--+--+--+  +
|  |     |           |  |     |  |           |        |     |
+--+  +  +--+--+--+--+  +  +  +  +  +--+--+--+--+  +  +  +  +
|     |  |        |     |  |  |  |     |        |  |  |  |  |
+  +--+--+  +--+  +  +--+  +  +  +--+  +  +  +  +  +--+  +  +
|  |        |  |     |     |  |  |     |  |  |     |     |  |
+  +  +--+--+  +--+--+--+  +--+  +  +--+--+  +--+--+  +--+  +
|  |  |                 |     |  |        |        |  |  |  |
+  +  +--+--+--+--+  +  +--+  +  +--+--+  +  +--+  +  +  +  +
|     |              |        |        |  |     |  |  |  |  |
+  +--+  +--+--+--+--+--+--+  +--+  +  +  +--+--+  +  +  +  +
|  |     |        |              |  |  |  |        |  |     |
+  +--+  +  +--+  +  +--+--+--+--+  +--+  +  +--+--+  +  +--+
|     |  |     |  |        |  |     |     |  |     |  |     |
+--+  +  +--+  +--+--+--+  +  +  +  +  +--+  +  +  +  +--+  +
|     |     |  |           |  |  |  |     |  |  |     |  |  |
+  +--+--+  +  +  +--+--+--+  +  +--+--+  +  +  +--+--+  +  +
|           |                 |              |  |           |
+S-+--+--+--+--+--+--+--+--+--+--+--+--+--+--+G-+--+--+--+--+
